0000000000000000
0000000000000000
00y0000000000000
0000000000000000
0000011111000000
0000011111000000
0000011111000000
0000011111000000
0000000000000000
0000000000000000
0000000000000000
0000000000000000
0000000000000000
0000000000000x00
0000000000000000
0000000000000000